NO assets/textures/NO.xpm
	SO assets/textures/SO.xpm

EA assets/textures/EA.xpm
	WE assets/textures/WE.xpm




F 51, 47, 44
C 119, 119, 119

111111111111111111111111111
11000000000000000000000000011111111111111111
10000000000000000000000000000000000000000001111
100000000000000000000000000000000000000000010001
100000000000000000000010000000000000000000000101
100000111110000000000111111111111111111111111001
10000010001000000000001111111000100010001000101
10000010N00000000000000000000010001000100010001
10000010001000000000000111111111111111111111111
100000111110000000000001
100000000000000000000001
100000000000111100000001
100000000000011100000001
100000000000001100000001
100000000000000000000001
111111111000000000000001
        1111111111111111
		
		111
		101
		111
